NO ./assets/textures/new/redbrick.png
SO ./assets/textures/new/purplestone.png
WE ./assets/textures/new/redbrick.png
EA ./assets/textures/new/purplestone.png

F 220,100,0
C 225,30,0

1111111111111111111111111111
1000000000000000000000000001
1000000000000000000000000001
1000000000000000000000000001
1000000000000000000000000001
1000000000000000000000000001
1000000000000000000000000001
1000000000000000000000000001
1000000000000000000000000001
1000000000000000000000000001
1000000000000000000000000001
1000000000000000000000000S01
1111111111111111111111111111
