NO ./path_to_the_north_texture
SO ./path_to_the_south_texture
WE ./path_to_the_west_texture
EA ./path_to_the_east_texture

F 117, 142, 79
C 135, 245, 251

111111111111
100000000111
111100000111
100000000111
100011101111
100000100111
100000100111
100000000001
1000S0000001
100000000001
100001110111
100001000001
100001000001
111111111111