NO ./assets/textures/new/mossy.png
SO ./assets/textures/new/redbrick.png
WE ./assets/textures/new/mossy.png
EA ./assets/textures/new/redbrick.png

F 117, 142, 79
C 135, 245, 251

111111111111
100000000111
111100000111
100000000111
100011101111
100000100111
100000100111
100000000001
100000000001
100000000001
100001110111
100001000001
100001000S01
111111111111