NO  ./assets/textures/STARG3_64.png
WE  ./assets/textures/STARG3_64.png
EA  ./assets/textures/STARG2_64.png
SO  ./assets/textures/STARG2_64.png

F 124,142,12
C 12,220,125

1111111111
1000000001
1111000001
1000000001
1W00001001
1000001001
1000001001
1111111111